111111111111111111111111111111111111111
100000000001000P0000000C0000000C0000011
10000E010000000000000C00000000000C00001
10001C000000000000000001111110100000001
1000C0000000001111111C00000000000000001
1000000011111000C0000011111111111111111
111111111111111111111111111111111111111