1111111111111111
100000000C000001
10E0110PC0110C01
10010010010C1001
1010C00110C00101
1C001C0C000C00C1
10001111000010C1
1111111111111111