11111111111111111111111111111
1E0000000000000C000C000100001
10100101001000001001000010101
101001001010101000010001C0101
1010010100100000100C000010101
10100100101010100001000010101
1P0000000C00C00000000000000C1
11111111111111111111111111111