1111111111111111
10000P0000C00001
10E00000C1111111
1111111111111111