1111111111111111
1000100001001001
1010001000100101
10P100E000101001
1001001000100001
1010000100010001
1000100C00100001
1111111111111111
