11111111111111111111111111111
10000000E00000000000000100001
10100101001000001001000010101
10100100101010100001000100101
10100101001000001000000010101
10100100101010100001000010101
10P000000000000000C0000000001
11111111111111111111111111111