1111111111111111
1000000101001001
101C010001000101
100100E000101001
1000000000C01001
101000000P011001
100010C100100001
1111111111111111