1111111111111111
1000000101001001
101C01P001000101
100100E000101001
1000000000C00001
1010000100001001
1000100100100001
1111111111111111
