1111111111111111
1000100001001001
101C00P000100101
100100E000101001
1001001000100001
1010000100010001
1000100100100001
1111111111111111
