11111111111111111111111111111
100000000000000C000C000100001
1010010100100E001001000010101
101001001010101000010001C0101
1010010100100000100C000010101
10100100101010100001000010101
1P0000000C00C00000000000000C1
11111111111111111111111111111